\...\..........|..\........../...............................\.\.....................................-........
..........................--............/.....-.../............-........................\./.\|\...............
...|.-\.|.......|......../.....-........|........................\......|..............\......|...............
...-\.....................\......../....../..............................|........-.........\...-\....-.......
.........\|............/-....-......-................\....-........|./.........-..|....................|......
..-.....\........................-.....-..../..............||.............-.................|..........-.-././
......................-\......................................-/......||.........-.-......./..................
|..\................|.....\.............\.......|........-..................\|.................|...-..........
............................|.....|.......\../..........\......\../..|..../........-..\.-......-..............
\....-.....................\....../............-/..|.........../-.........|.../................\.......|\...//
.......-.-........../........-.........\..../......................|.............|.....\....|......../........
.../......../.........|.....-.............|.....\\-.|..\..........\..|...............-.|...........-......-../
............./.............../......./.................-.................|/...||............|.............|\..
...................-..................................../.\..................|..........|........|...../..|./.
.........................|......\..../...........|..-......|..-.-../..\.......\............................|..
.........\..|...............//.........|................|................................./..-..-.............
......||...........|...|../.............../....-......|..\.....-..........\..................\.........../....
............../-......|.................-......|........-...--................./.............|..........\.....
......\.|./...........\...................\..-.........-.....-.-.......|./....................../.|..\|.......
./...........\..|...................../....................................\../.................\...........\.
..............|............................./...\.............../.....-.........\./..-.../\\..................
\./|......\............|.........................|....-../.......\........./.............../-........../....\.
....-................................\....................../.|...|.................-...|.......--............
.......-....\/../.................-/...-./...-...........................-.............\...........|..........
................................................\........./............../.....|.......\......|........\./....
..........-..../......-.............|...-.....\..-......................-..\.....|....../....\./.....|........
.......-...../..................-....../........./......./..............|......-....|....|.\....|......-./-...
......\/.....................|.-.........-.....\.....................-.-....|.................|.-\./..........
............\...........-................|....|....|-......\..|/............\........-...-..........-....\....
...\............-...........|.............|...............-......|.............\..\................\..........
...........................|..........|..................\..\........|...../......|....|..........-...........
.......-.../..................-...\\.....\..-.....|/..................................-.........../...........
/......\.\........................../|........................-........-..................-..............-.|..
../............|\......|....|.........................../....-..\.............../.............-........|......
........./.........|\........................|.\....................|\........................|....../........
.../..........|......../....-......../.................\................-...\............/...........-....|...
...................../...../../..-........\/............-./..|................../.............................
............./.......\..-/.........\..../..................|.\...\...-..-.-............\..../....|........|\..
...../........|..............\..|.|...|.-......-....\.......................-.\.......\...........|...........
..............\..|................................/-.....-...|.............\..//..\......|...............|....
...............................-......|\............../.\.\............./......\..............................
............|/...\.....|.......|..\....................\.../..................................................
|........../......../............\../...\...\.....-........|../................\-.............../.........\...
.....|...-...................../..-...................\........|./.......-...\-.../....|.................|....
...........-..................................\.......\....../..............................|.................
........./.\................\...-.|........./......\................-.../........|...\.....\.....|............
.-....../......./....-...................\.............-....................|.-.\./........................\..
........./...../..........................-...............\........-....................................\.....
\..|...........................\/...-................................................./.......-..\....\.......
....-.|/../...../......./....................-..........-......-.........\.........../...................\....
.................................../.........|...........................\.....-..../.........................
............/..../.../......\........................-.......|............-........./|........-...............
../......../..........-.........................................................-.........\..-|...............
...../../...................|.................|.........................................../......./..........\
...|..........||......................./......./...-..|..\/......./................\.\........../...\.........
..-.\\..|................|....-.......................................-......../.../............|.............
..............-../...............................-.......................\....................|..........././.
...\............/.................|.-.|............./......|......-./...............\.\.................-.....
.............|.............\......|.................-|...|.........|.....-......../.......|...................
...\-............-..-................/.............-.......\............\.........-|...\.............|........
..........|.....\...../...\....../|.|.|......../-....--....\........|...........|..........\..................
...............\......./.....|............................|./.............-.|.......\.-............\.......|..
....-..........................|\....................................................................-........
............\........|...../\/-........|./.......|..-........................../../.......-..........-........
-..\............\..\.../.......\.........\..............\....../...........-.......\....................|.....
........|..........|.............|.............-..|..................|....-\.././......|.............|........
..../......................../|..|......................|..............................|...................-..
.......-/.../........-........................\....-./.-...........|........./....\...........-...../.........
........./-\........../.................-.......\...................-...\.......\.-...........\...............
.........................\.../..........................||..|.|...............................................
...................-........./..../........................\................-.....................|...........
...................................|.....\...........|.........\.../.-.-.......-....-....\.............//.|.|.
..../............|-.......././.........-............\.....-......-................-......\........\.........-.
.\......................\.|...\.-........\..............-..................-.........................../.../..
..............|..\../...............\|..........\./...................\...........|...........................
....|......\.-\.................-..................../........\....-...../.............-.\.|..................
......................-.|..|........................\...............-..\..-..../....../...........|...\.......
...........|......\................../....-...\|................\......../|........................|.........-
...........-.............-...-................\...-.......|.........../........-..............................
............|................|....--.........../-.....|......\.............../.........../...|................
-.....\............/....../.......|.........../...............................-.....//.................-......
-..............|...........-..........|..-|-...-...........................................\...........|......
...../......|........-...\.................-......|.......-.......................|..................././..-..
\..........................................\...-..\......./......-.......\.....|..\....\.../.\..........|...\.
............./.........-............../....|..../...-....|...-........\............\...................|......
/.......|-..../..\.....\..............................\............|..............-.....|..../............-...
............\................................................/......\..............\.|........................
\/..../.........|\.....|.../....................../.../..-............-..........-.../.-..../.................
.......|-..|...................../................\..............\............/........../\...|..../..........
........................................................................\............/.....-.\.-..............
.......................\.........../........\......./.........|.............\..|....................-.........
.|.../-.......-.....\...................|.........||..\...|.-....|....\..............\.......-.|.......\/.....
........../.|.........|............../........\...........|.-..................\.\-..........\...-............
....\./..........\.........\../......||........\..\......-..........................................\....\....
|...........\.............../.....|............|..............\...............-............|....\.....-.......
.||................................|..|..\../...-........................\..................\.......|.........
....................-.....\..........................-|--|../.\............................||......../........
........|..../........................|........\....-...|.../.............|.../../....\..-..............-.....
.......\...\......-...-.....................|....\............-...|.-....\.....-......-.......................
..-......./...................../..../..........-\......./..-./.................\.\..............|............
....../............../................\.........-......./..................................././...|...........
......|-..................|-....|...../.|....................-............................\...................
...........|.......................................|....\........./......./../......................\|........
..............|.\........../.........................../......|.........................../............./../..
.........-......\........\........-..........|...|..............|........./....-........../.././......./......
............|.........\.......\.........|..............-......./.....|/....../......./....\.........-\........
.............-.../..................-.......\...................-/......-.........|........................\..
...............|.\-|//..\.|............................................/..../...........\-....................
..........|......./...\../|.............................................................................../...
...........................|.....--..................................-....\...||-........./\......-.....\.\...